10.oX
.o.o.o...
o..oo...o
.........
...oo....
.........
.........
.........
.........
..o......
..o...ooo
