1111111111
1P00000001
1C00000001
11111110X1
1000001001
1101001001
1E0C1000C1
1111111111
