11111111111111111111111111111111111
100010000000001100000000011111000C1
10101C10100100011101111100000001111
101000101001C100000000C1001101100P1
101101101001111X0E01111100100100101
1010001C0000010CX001000X00101101001
1C1010111110010X1001111100101X01011
1X00100C1CCC000010000000001000010C1
11111111111111111111111111111111111
