0111111
1000001
10E0001
1111111
