11111111111111111111111111111
100000XC0000CE111C000000XC001
1CX00000C000111111111110000C1
10000C000000000000000000X1111
1C00000000X1111111111100000C1
100111111111111111111111C0011
10C000000000C0000000001110011
1C00000C00000000C000000C11001
11111111111111111111C111111C1
1C0000000C00000000000011111P1
1C111111111111111111111111111
11111111111111111111111111111
