111111111111111111111
10CX00CX00C1C0000C001
10X000X00111111C11X01
10000X000C000C000C001
10110C01110P000X01001
1C110100C011111100001
111101111011111C10X11
1C000X0X00C00000X00E1
111111111111111111111
