111111111111111111111111111111
100000000000000000000000000001
10P000000000000000000000000001
100000000000000000C00000000001
100000000000000000000000000001
100000000000000000000000000001
1000000000000000000000000XE1C1
111111111111111111111111111111
